['/computer/software/software_genre', 'df-schema#seeAlso']	/computer/software/software_genre	/government/government_office_or_title/category	1105
['/organization/organization/child./organization/organization_relationship/child', '/subsidiary']	/organization/organization/child./organization/organization_relationship/child	/fictional_universe/fictional_character/married_to./fictional_universe/marriage_of_fictional_characters/spouses	511
['/soccer/football_team/current_roster./sports/sports_team_roster/player', '/name']	/soccer/football_team/current_roster./sports/sports_team_roster/player	/base/contractbridge/bridge_player/second_place_finish./base/contractbridge/bridge_tournament_standings/first_place	1295
['/ice_hockey/hockey_player/hockey_position', '/position']	/ice_hockey/hockey_player/hockey_position	/base/activism/activism_issue/activist_organizations	852
['/military/military_person/service./military/military_service/military_force', '/militaryBranch']	/military/military_person/service./military/military_service/military_force	/basketball/basketball_team/roster./sports/sports_team_roster/position	434
['/organization/organization/product_of_merger./organization/organization_merger/organizations_merging', 'df-schema#seeAlso']	/organization/organization/product_of_merger./organization/organization_merger/organizations_merging	/government/government_office_or_title/category	1085
['/influence/influence_node/influenced_by', '/influencedBy']	/influence/influence_node/influenced_by	/architecture/structure/architect	972
['/architecture/museum/type_of_museum', '/type']	/architecture/museum/type_of_museum	/base/localfood/produce/availability./base/localfood/produce_availability/seasonal_months	1320
['/geography/lake/cities', '/nearestCity']	/geography/lake/cities	/transportation/road/major_cities	1310
['/film/producer/film', '/award']	/film/producer/film	/relative	1332
['/tv/tv_program/original_network./tv/tv_network_duration/network', '/network']	/tv/tv_program/original_network./tv/tv_network_duration/network	/military/armed_force/personnel./military/military_service/military_person	877
['/base/argumentmaps/innovator/original_ideas', '/knownFor']	/base/argumentmaps/innovator/original_ideas	/base/locations/countries/continent	314
['/baseball/baseball_player/former_teams./baseball/baseball_historical_roster_position/team', '/debutTeam']	/baseball/baseball_player/former_teams./baseball/baseball_historical_roster_position/team	/media_common/dedicated_work/dedication./media_common/dedication/dedicated_to	1534
['/military/military_combatant/casualties./military/casualties/military_conflict', 'df-schema#seeAlso']	/military/military_combatant/casualties./military/casualties/military_conflict	/government/government_office_or_title/category	1062
['/government/politician/government_positions_held./government/government_position_held/appointed_by', '/president']	/government/politician/government_positions_held./government/government_position_held/appointed_by	/people/marriage_union_type/unions_of_this_type./people/marriage/spouse	226
['/music/artist/label', '/recordLabel']	/music/artist/label	/base/localfood/food_producing_region/seasonal_availability./base/localfood/produce_availability/produce	138
['/film/film_festival_event/films', '/openingFilm']	/film/film_festival_event/films	/sports/sports_award_winner/awards./sports/sports_award/season	133
['/people/person/spouse_s./people/marriage/location_of_ceremony', '/birthPlace']	/people/person/spouse_s./people/marriage/location_of_ceremony	/cvg/game_series/games_in_series	1119
['/business/business_operation/retained_earnings./measurement_unit/dated_money_value/currency', '/revenue']	/business/business_operation/retained_earnings./measurement_unit/dated_money_value/currency	/food/dish/ingredients	323
['/sports/sports_team/sport', 'df-schema#seeAlso']	/sports/sports_team/sport	/government/government_office_or_title/category	1028
['/tv/tv_program/genre', '/genre']	/tv/tv_program/genre	/base/popstra/celebrity/friendship./base/popstra/friendship/participant	881
['/book/newspaper/headquarters./location/mailing_address/state_province_region', '/headquarter']	/book/newspaper/headquarters./location/mailing_address/state_province_region	/martial_arts/martial_artist/martial_art	1212
['/military/military_person/participated_in_conflicts', '/battle']	/military/military_person/participated_in_conflicts	/book/periodical/publisher./book/periodical_publisher_period/publisher	1348
['/protected_sites/listed_site/designation_as_natural_or_cultural_site./protected_sites/natural_or_cultural_site_listing/designation', '/campus']	/protected_sites/listed_site/designation_as_natural_or_cultural_site./protected_sites/natural_or_cultural_site_listing/designation	/cvg/computer_videogame/developer	1341
['/sports/pro_athlete/teams./soccer/football_roster_position/position', '/position']	/sports/pro_athlete/teams./soccer/football_roster_position/position	/base/activism/activism_issue/activist_organizations	1457
['/media_common/netflix_title/netflix_genres', '/country']	/media_common/netflix_title/netflix_genres	/locationCountry	955
['/sports/pro_athlete/sports_played_professionally./sports/pro_sports_played/sport', '/occupation']	/sports/pro_athlete/sports_played_professionally./sports/pro_sports_played/sport	/base/popstra/celebrity/breakup./base/popstra/breakup/participant	283
['/base/popstra/celebrity/hangout./base/popstra/hangout/business_location', '/birthDate']	/base/popstra/celebrity/hangout./base/popstra/hangout/business_location	/aviation/airline/airports_served./aviation/airline_airport_presence/airport	1318
['/basketball/basketball_player/team./basketball/basketball_roster_position/team', '/team']	/basketball/basketball_player/team./basketball/basketball_roster_position/team	/book/periodical_subject/periodicals	1332
['/base/biblioness/bibs_location/state', '/isPartOf']	/base/biblioness/bibs_location/state	/american_football/football_player/games./american_football/player_game_statistics/team	332
['/media_common/dedicatee/dedications./media_common/dedication/work_dedicated', '/award']	/media_common/dedicatee/dedications./media_common/dedication/work_dedicated	/relative	143
['/computer/operating_system/developer', '/developer']	/computer/operating_system/developer	/medicine/disease/risk_factors	470
['/common/topic/webpage./common/webpage/topic', '/associatedBand']	/common/topic/webpage./common/webpage/topic	/music/performance_role/track_performances./music/track_contribution/role	35
['/award/award_nominated_work/award_nominations./award/award_nomination/nominated_for', 'df-schema#seeAlso']	/award/award_nominated_work/award_nominations./award/award_nomination/nominated_for	/government/government_office_or_title/category	936
['/geography/body_of_water/islands', '/island']	/geography/body_of_water/islands	/film/film/story_by	649
['/location/location/partially_containedby', '/state']	/location/location/partially_containedby	/government/governmental_jurisdiction/governing_officials./government/government_position_held/governmental_body	887
['/book/author/school_or_movement', '/movement']	/book/author/school_or_movement	/base/marchmadness/ncaa_basketball_team/ncaa_tournament_seeds./base/marchmadness/ncaa_tournament_seed/tournament	1158
['/business/asset/owners./business/asset_ownership/owner', '/predecessor']	/business/asset/owners./business/asset_ownership/owner	/sports/sports_league_season/awards./sports/sports_award/award_winner	627
['/tv/tv_actor/starring_roles./tv/regular_tv_appearance/special_performance_type', '/occupation']	/tv/tv_actor/starring_roles./tv/regular_tv_appearance/special_performance_type	/base/popstra/celebrity/breakup./base/popstra/breakup/participant	1102
['/education/academic/research_areas', '/mainInterest']	/education/academic/research_areas	/american_football/football_player/receiving./american_football/player_receiving_statistics/season	889
['/location/us_county/hud_county_place', '/countySeat']	/location/us_county/hud_county_place	/business/asset_owner/assets_owned./business/asset_ownership/owned_asset	1107
['/base/biblioness/bibs_location/city', '/isPartOf']	/base/biblioness/bibs_location/city	/american_football/football_player/games./american_football/player_game_statistics/team	51
['/organization/organization/organization_type', '/type']	/organization/organization/organization_type	/base/localfood/produce/availability./base/localfood/produce_availability/seasonal_months	1562
['/sports/sports_league/sport', 'df-schema#seeAlso']	/sports/sports_league/sport	/government/government_office_or_title/category	1431
['/basketball/basketball_player/former_teams./basketball/basketball_historical_roster_position/team', '/team']	/basketball/basketball_player/former_teams./basketball/basketball_historical_roster_position/team	/book/periodical_subject/periodicals	970
['/soccer/football_player/position_s', '/position']	/soccer/football_player/position_s	/base/activism/activism_issue/activist_organizations	806
['/organization/organization/legal_structure', '/type']	/organization/organization/legal_structure	/base/localfood/produce/availability./base/localfood/produce_availability/seasonal_months	1416
['/film/director/film', '/award']	/film/director/film	/relative	1441
['/film/film/starring./film/performance/character', 'df-schema#seeAlso']	/film/film/starring./film/performance/character	/government/government_office_or_title/category	588
['/award/hall_of_fame_inductee/hall_of_fame_inductions./award/hall_of_fame_induction/hall_of_fame', '/honours']	/award/hall_of_fame_inductee/hall_of_fame_inductions./award/hall_of_fame_induction/hall_of_fame	/religion/religious_organization/associated_with	312
['/royalty/kingdom/rulers', '/leaderName']	/royalty/kingdom/rulers	/biology/animal_breed/registered_with./biology/breed_registration/registry	677
['/base/schemastaging/organization_extra/phone_number./base/schemastaging/phone_sandbox/service_language', '/language']	/base/schemastaging/organization_extra/phone_number./base/schemastaging/phone_sandbox/service_language	/base/eating/diets/people_who_follow_this_diet	561
['/government/politician/government_positions_held./government/government_position_held/office_position_or_title', '/office']	/government/politician/government_positions_held./government/government_position_held/office_position_or_title	/food/ingredient/compatible_with_dietary_restrictions	655
['/baseball/baseball_player/current_team./sports/sports_team_roster/team', '/team']	/baseball/baseball_player/current_team./sports/sports_team_roster/team	/book/periodical_subject/periodicals	1206
['/ice_hockey/hockey_player/former_team_s./sports/sports_team_roster/team', '/formerTeams']	/ice_hockey/hockey_player/former_team_s./sports/sports_team_roster/team	/governmentType	1555
['/base/aareas/schema/administrative_area/administrative_children', '/capital']	/base/aareas/schema/administrative_area/administrative_children	/tv/tv_program_guest/appeared_on./tv/tv_guest_personal_appearance/appearance_type	836
['/film/writer/film', '/knownFor']	/film/writer/film	/base/locations/countries/continent	1269
['/base/saints/saint/venerated_in', '/veneratedIn']	/base/saints/saint/venerated_in	/film/actor/dubbing_performances./film/dubbing_performance/language	623
['/american_football/football_player/receiving./american_football/player_receiving_statistics/team', '/team']	/american_football/football_player/receiving./american_football/player_receiving_statistics/team	/book/periodical_subject/periodicals	1237
['/business/brand/owner_s./business/company_brand_relationship/company', '/owningCompany']	/business/brand/owner_s./business/company_brand_relationship/company	/language/language_dialect/language	267
['/education/educational_institution/school_type', '/type']	/education/educational_institution/school_type	/base/localfood/produce/availability./base/localfood/produce_availability/seasonal_months	1279
['/tv/tv_program/languages', '/language']	/tv/tv_program/languages	/base/eating/diets/people_who_follow_this_diet	246
['/geography/river/mouth', '/riverMouth']	/geography/river/mouth	/soccer/football_player/position_s	1281
['/base/activism/activist/area_of_activism', '/party']	/base/activism/activist/area_of_activism	/tv/tv_writer/tv_programs./tv/tv_program_writer_relationship/tv_program	1043
['/computer/programming_language/influenced_by', '/influencedBy']	/computer/programming_language/influenced_by	/architecture/structure/architect	656
['/location/location/street_address./location/mailing_address/citytown', '/city']	/location/location/street_address./location/mailing_address/citytown	/baseball/baseball_team/league	665
['/base/popstra/celebrity/vacations_in./base/popstra/vacation_choice/location', '/birthPlace']	/base/popstra/celebrity/vacations_in./base/popstra/vacation_choice/location	/cvg/game_series/games_in_series	659
['/royalty/system_of_nobility/titles./royalty/system_title_relationship/title', 'df-schema#seeAlso']	/royalty/system_of_nobility/titles./royalty/system_title_relationship/title	/government/government_office_or_title/category	721
['/basketball/basketball_player/former_teams./sports/sports_team_roster/team', '/team']	/basketball/basketball_player/former_teams./sports/sports_team_roster/team	/book/periodical_subject/periodicals	556
['/base/biblioness/bibs_location/country', '/country']	/base/biblioness/bibs_location/country	/locationCountry	501
['/location/administrative_division/second_level_division_of', '/country']	/location/administrative_division/second_level_division_of	/locationCountry	937
['/location/statistical_region/places_imported_from./location/imports_and_exports/imported_from', '/place']	/location/statistical_region/places_imported_from./location/imports_and_exports/imported_from	/education/academic_institution/visiting_scholars_fellows_etc./education/academic_post/person	263
['/music/performance_role/regular_performances./music/group_membership/role', 'df-schema#seeAlso']	/music/performance_role/regular_performances./music/group_membership/role	/government/government_office_or_title/category	781
['/military/military_conflict/combatants./military/military_combatant_group/combatants', '/place']	/military/military_conflict/combatants./military/military_combatant_group/combatants	/education/academic_institution/visiting_scholars_fellows_etc./education/academic_post/person	243
['/tv/tv_program/regular_cast./tv/regular_tv_appearance/actor', '/starring']	/tv/tv_program/regular_cast./tv/regular_tv_appearance/actor	/genre	160
['/base/x2010fifaworldcupsouthafrica/world_cup_participant/world_cup_team./base/x2010fifaworldcupsouthafrica/current_world_cup_squad/position', '/position']	/base/x2010fifaworldcupsouthafrica/world_cup_participant/world_cup_team./base/x2010fifaworldcupsouthafrica/current_world_cup_squad/position	/base/activism/activism_issue/activist_organizations	973
['/sports/sports_team/location', '/locationCity']	/sports/sports_team/location	/comic_books/comic_book_creator/characters_created	1136
['/location/location/containedby', '/country']	/location/location/containedby	/locationCountry	1407
['/film/film/runtime./film/film_cut/film_release_region', '/country']	/film/film/runtime./film/film_cut/film_release_region	/locationCountry	878
['/film/film/distributors./film/film_film_distributor_relationship/distributor', '/distributor']	/film/film/distributors./film/film_film_distributor_relationship/distributor	/award/award_category/winners./award/award_honor/award_winner	1556
['/tv/tv_personality/tv_regular_appearances./tv/tv_regular_personal_appearance/program', '/knownFor']	/tv/tv_personality/tv_regular_appearances./tv/tv_regular_personal_appearance/program	/base/locations/countries/continent	651
['/film/film/sequel', '/nextAlbum']	/film/film/sequel	/debutTeam	1006
['/celebrities/celebrity/sexual_relationships./celebrities/romantic_relationship/celebrity', '/spouse']	/celebrities/celebrity/sexual_relationships./celebrities/romantic_relationship/celebrity	/formerBandMember	1425
['/government/politician/government_positions_held./government/government_position_held/governmental_body', '/office']	/government/politician/government_positions_held./government/government_position_held/governmental_body	/food/ingredient/compatible_with_dietary_restrictions	625
['/government/governmental_jurisdiction/governing_officials./government/government_position_held/basic_title', '/leaderTitle']	/government/governmental_jurisdiction/governing_officials./government/government_position_held/basic_title	/education/educational_institution/sexes_accepted./education/gender_enrollment/sex	1421
['/music/genre/subgenre', '/musicSubgenre']	/music/genre/subgenre	/tv/tv_program/subjects	919
['/government/legislative_session/members./government/government_position_held/jurisdiction_of_office', 'df-schema#seeAlso']	/government/legislative_session/members./government/government_position_held/jurisdiction_of_office	/government/government_office_or_title/category	917
['/organization/organization/parent./organization/organization_relationship/parent', '/parentCompany']	/organization/organization/parent./organization/organization_relationship/parent	/geography/geographical_feature/category	243
['/film/film/other_crew./film/film_crew_gig/crewmember', '/director']	/film/film/other_crew./film/film_crew_gig/crewmember	/military/military_person/participated_in_conflicts	352
['/aviation/airport/serves', '/city']	/aviation/airport/serves	/baseball/baseball_team/league	637
['/education/field_of_study/students_majoring./education/education/specialization', 'df-schema#seeAlso']	/education/field_of_study/students_majoring./education/education/specialization	/government/government_office_or_title/category	1004
['/people/person/education./education/education/degree', '/almaMater']	/people/person/education./education/education/degree	/education	724
['/organization/organization/involved_in_merger./organization/organization_merger/organizations_merging', '/predecessor']	/organization/organization/involved_in_merger./organization/organization_merger/organizations_merging	/sports/sports_league_season/awards./sports/sports_award/award_winner	934
['/baseball/baseball_player/former_teams./sports/sports_team_roster/team', '/debutTeam']	/baseball/baseball_player/former_teams./sports/sports_team_roster/team	/media_common/dedicated_work/dedication./media_common/dedication/dedicated_to	1323
['/education/academic/advisors', '/influences']	/education/academic/advisors	/music/album/artist	794
['/tv/tv_program/country_of_origin', '/country']	/tv/tv_program/country_of_origin	/locationCountry	1007
['/film/producer/films_executive_produced', '/award']	/film/producer/films_executive_produced	/relative	1168
['/language/human_language/region', '/spokenIn']	/language/human_language/region	/base/argumentmaps/morally_disputed_activity/instance_of_abstract_moral_dispute	1088
['/business/board_member/leader_of./organization/leadership/organization', '/occupation']	/business/board_member/leader_of./organization/leadership/organization	/base/popstra/celebrity/breakup./base/popstra/breakup/participant	1581
['/book/newspaper_owner/newspapers_owned', '/product']	/book/newspaper_owner/newspapers_owned	/book/written_work/subjects	271
['/military/military_conflict/commanders./military/military_command/military_commander', '/commander']	/military/military_conflict/commanders./military/military_command/military_commander	/medicine/condition_prevention_factors/conditions_this_may_prevent	348
['/geography/river/cities', '/city']	/geography/river/cities	/baseball/baseball_team/league	1235
['/geography/river/basin_countries', '/country']	/geography/river/basin_countries	/locationCountry	414
['/cvg/computer_videogame/cvg_genre', '/genre']	/cvg/computer_videogame/cvg_genre	/base/popstra/celebrity/friendship./base/popstra/friendship/participant	208
['/sports/sports_award_winner/awards./sports/sports_award/award', '/league']	/sports/sports_award_winner/awards./sports/sports_award/award	/base/locations/countries/continent	1139
['/broadcast/tv_station/owner', '/owningCompany']	/broadcast/tv_station/owner	/language/language_dialect/language	505
['/baseball/baseball_league/teams', '/champion']	/baseball/baseball_league/teams	/film/film/prequel	607
['/people/ethnicity/includes_groups', 'df-schema#seeAlso']	/people/ethnicity/includes_groups	/government/government_office_or_title/category	1176
['/tv/tv_program/filming_locations', '/location']	/tv/tv_program/filming_locations	/protected_sites/site_listing_category/listed_sites./protected_sites/natural_or_cultural_site_listing/listed_site	99
['/business/business_operation/net_profit./measurement_unit/dated_money_value/currency', '/revenue']	/business/business_operation/net_profit./measurement_unit/dated_money_value/currency	/food/dish/ingredients	101
['/education/school/lowest_grade_taught', '/grades']	/education/school/lowest_grade_taught	/base/usnationalparks/us_national_park/state	1158
['/location/statistical_region/gdp_real./measurement_unit/adjusted_money_value/adjustment_currency', '/currency']	/location/statistical_region/gdp_real./measurement_unit/adjusted_money_value/adjustment_currency	/olympics/olympic_athlete/medals_won./olympics/olympic_medal_honor/country	241
['/cvg/computer_videogame/developer', '/publisher']	/cvg/computer_videogame/developer	/user/robert/military/military_person/participated_in_conflicts	180
['/award/award_winning_work/awards_won./award/award_honor/ceremony', 'df-schema#seeAlso']	/award/award_winning_work/awards_won./award/award_honor/ceremony	/government/government_office_or_title/category	28
['/cvg/computer_videogame/designers', '/producer']	/cvg/computer_videogame/designers	/base/popstra/celebrity/supporter./base/popstra/support/supported_organization	861
['/film/film/executive_produced_by', '/producer']	/film/film/executive_produced_by	/base/popstra/celebrity/supporter./base/popstra/support/supported_organization	1437
['/organization/organization/founders', '/foundedBy']	/organization/organization/founders	/tv/tv_series_season/regular_cast./tv/regular_tv_appearance/seasons	1486
['/education/educational_institution/colors', '/colours']	/education/educational_institution/colors	/basketball/basketball_player/team./sports/sports_team_roster/team	1522
['/government/government_agency/jurisdiction', '/country']	/government/government_agency/jurisdiction	/locationCountry	1033
['/sports/pro_athlete/teams./sports/sports_team_roster/team', '/team']	/sports/pro_athlete/teams./sports/sports_team_roster/team	/book/periodical_subject/periodicals	527
['/film/film/release_date_s./film/film_regional_release_date/film_release_region', '/country']	/film/film/release_date_s./film/film_regional_release_date/film_release_region	/locationCountry	1320
['/soccer/football_team/league./soccer/football_league_participation/league', '/league']	/soccer/football_team/league./soccer/football_league_participation/league	/base/locations/countries/continent	1054
['/tv/tv_program/tv_producer./tv/tv_producer_term/producer', '/executiveProducer']	/tv/tv_program/tv_producer./tv/tv_producer_term/producer	/film/film_character/portrayed_in_films./film/performance/actor	1043
['/base/activism/organization/area_of_activism', '/parentOrganisation']	/base/activism/organization/area_of_activism	/organization/organization/parent./organization/organization_relationship/parent	328
['/user/alexander/misc/murdered_person/place_murdered', '/deathPlace']	/user/alexander/misc/murdered_person/place_murdered	/fictional_universe/fictional_character/place_of_birth	365
['/location/statistical_region/gni_per_capita_in_ppp_dollars./measurement_unit/dated_money_value/currency', '/currency']	/location/statistical_region/gni_per_capita_in_ppp_dollars./measurement_unit/dated_money_value/currency	/olympics/olympic_athlete/medals_won./olympics/olympic_medal_honor/country	662
['/music/artist/origin', '/birthPlace']	/music/artist/origin	/cvg/game_series/games_in_series	1406
['/people/person/languages', '/language']	/people/person/languages	/base/eating/diets/people_who_follow_this_diet	300
['/people/person/nationality', '/birthPlace']	/people/person/nationality	/cvg/game_series/games_in_series	767
['/location/country/currency_used', '/currency']	/location/country/currency_used	/olympics/olympic_athlete/medals_won./olympics/olympic_medal_honor/country	242
['/education/educational_institution/sports_teams', 'df-schema#seeAlso']	/education/educational_institution/sports_teams	/government/government_office_or_title/category	1026
['/sports/pro_athlete/teams./american_football/football_historical_roster_position/position_s', '/position']	/sports/pro_athlete/teams./american_football/football_historical_roster_position/position_s	/base/activism/activism_issue/activist_organizations	1426
['/time/event/includes_event', '/place']	/time/event/includes_event	/education/academic_institution/visiting_scholars_fellows_etc./education/academic_post/person	1566
['/soccer/football_player/current_team./sports/sports_team_roster/position', '/position']	/soccer/football_player/current_team./sports/sports_team_roster/position	/base/activism/activism_issue/activist_organizations	992
['/film/film/film_casting_director', '/director']	/film/film/film_casting_director	/military/military_person/participated_in_conflicts	1321
['/film/film_production_designer/films_production_designed', '/award']	/film/film_production_designer/films_production_designed	/relative	1001
['/award/award_nominee/award_nominations./award/award_nomination/award_nominee', '/associatedBand']	/award/award_nominee/award_nominations./award/award_nomination/award_nominee	/music/performance_role/track_performances./music/track_contribution/role	270
['/american_football/football_player/former_teams./sports/sports_team_roster/team', '/formerTeam']	/american_football/football_player/former_teams./sports/sports_team_roster/team	/medicine/icd_9_cm_classification/parent_classification	715
['/sports/sports_award_winner/awards./sports/sports_award/team', '/team']	/sports/sports_award_winner/awards./sports/sports_award/team	/book/periodical_subject/periodicals	1209
['/architecture/museum/address./location/mailing_address/citytown', '/location']	/architecture/museum/address./location/mailing_address/citytown	/protected_sites/site_listing_category/listed_sites./protected_sites/natural_or_cultural_site_listing/listed_site	1268
['/location/location/events', '/isPartOfMilitaryConflict']	/location/location/events	/lea	1273
['/music/performance_role/track_performances./music/track_contribution/role', 'df-schema#seeAlso']	/music/performance_role/track_performances./music/track_contribution/role	/government/government_office_or_title/category	811
['/user/szaijan/fantasy_football/player/position', '/position']	/user/szaijan/fantasy_football/player/position	/base/activism/activism_issue/activist_organizations	280
['/computer/software/license', '/license']	/computer/software/license	/sports/sports_team/roster./baseball/baseball_roster_position/player	942
['/book/newspaper/circulation_areas', '/headquarter']	/book/newspaper/circulation_areas	/martial_arts/martial_artist/martial_art	1387
['/influence/influence_node/influenced', '/influenced']	/influence/influence_node/influenced	/film/film/dubbing_performances./film/dubbing_performance/character	492
['/award/award_nominated_work/award_nominations./award/award_nomination/award_nominee', '/starring']	/award/award_nominated_work/award_nominations./award/award_nomination/award_nominee	/genre	430
['/government/government_office_or_title/office_holders./government/government_position_held/jurisdiction_of_office', 'df-schema#seeAlso']	/government/government_office_or_title/office_holders./government/government_position_held/jurisdiction_of_office	/government/government_office_or_title/category	820
['/sports/professional_sports_team/owner_s', '/owner']	/sports/professional_sports_team/owner_s	/colors	791
['/film/film/genre', '/genre']	/film/film/genre	/base/popstra/celebrity/friendship./base/popstra/friendship/participant	726
['/film/film/film_art_direction_by', '/director']	/film/film/film_art_direction_by	/military/military_person/participated_in_conflicts	460
['/location/country/capital', '/capital']	/location/country/capital	/tv/tv_program_guest/appeared_on./tv/tv_guest_personal_appearance/appearance_type	459
['/location/hud_county_place/county', '/isPartOf']	/location/hud_county_place/county	/american_football/football_player/games./american_football/player_game_statistics/team	434
['/user/robert/us_congress/us_representative/state', '/region']	/user/robert/us_congress/us_representative/state	/sports/pro_athlete/teams./basketball/basketball_roster_position/team	1578
['/education/educational_institution/students_graduates./education/education/major_field_of_study', 'wl#differentFrom']	/education/educational_institution/students_graduates./education/education/major_field_of_study	/user/coco/science/concepts_theories/child_concept	655
['/education/educational_institution/parent_institution', '/affiliation']	/education/educational_institution/parent_institution	/location/country/second_level_divisions	618
['/award/award_winner/awards_won./award/award_honor/award', '/award']	/award/award_winner/awards_won./award/award_honor/award	/relative	1324
['/architecture/architectural_style/architects', 'df-schema#seeAlso']	/architecture/architectural_style/architects	/government/government_office_or_title/category	1457
['/tv/tv_program/spun_off_from', '/related']	/tv/tv_program/spun_off_from	/base/saints/saint/venerated_in	1548
['/people/person/education./education/education/major_field_of_study', '/field']	/people/person/education./education/education/major_field_of_study	/position	1369
['/comic_books/comic_book_character/created_by', '/creator']	/comic_books/comic_book_character/created_by	/director	290
['/location/statistical_region/places_exported_to./location/imports_and_exports/exported_to', '/place']	/location/statistical_region/places_exported_to./location/imports_and_exports/exported_to	/education/academic_institution/visiting_scholars_fellows_etc./education/academic_post/person	485
['/military/military_conflict/military_personnel_involved', '/commander']	/military/military_conflict/military_personnel_involved	/medicine/condition_prevention_factors/conditions_this_may_prevent	995
['/music/artist/contribution./music/recording_contribution/performance_role', '/instrument']	/music/artist/contribution./music/recording_contribution/performance_role	/base/folklore/mythical_creature/mythology	592
['/sports/sports_league/teams./sports/sports_league_participation/team', '/mostChamps']	/sports/sports_league/teams./sports/sports_league_participation/team	/architecture/building_function/buildings	697
['/film/film/other_film_companies./film/film_film_company_relationship/film_company', '/distributor']	/film/film/other_film_companies./film/film_film_company_relationship/film_company	/award/award_category/winners./award/award_honor/award_winner	1490
['/people/person/religion', '/religion']	/people/person/religion	/award/award_winning_work/awards_won./award/award_honor/honored_for	1181
['/people/person/sibling_s./people/sibling_relationship/sibling', '/relative']	/people/person/sibling_s./people/sibling_relationship/sibling	/award	568
['/people/family_member/family', '/relation']	/people/family_member/family	/geography/geographical_feature/category	813
['/basketball/basketball_player/position_s', '/position']	/basketball/basketball_player/position_s	/base/activism/activism_issue/activist_organizations	1139
['/education/field_of_study/students_majoring./education/education/major_field_of_study', 'df-schema#seeAlso']	/education/field_of_study/students_majoring./education/education/major_field_of_study	/government/government_office_or_title/category	412
['/geography/lake/basin_countries', '/country']	/geography/lake/basin_countries	/locationCountry	451
['/media_common/dedicated_work/dedication./media_common/dedication/dedicated_by', '/director']	/media_common/dedicated_work/dedication./media_common/dedication/dedicated_by	/military/military_person/participated_in_conflicts	885
['/base/popstra/celebrity/lived_with./base/popstra/lived_with/participant', '/spouse']	/base/popstra/celebrity/lived_with./base/popstra/lived_with/participant	/formerBandMember	1496
['/computer/programming_language/influenced', '/influenced']	/computer/programming_language/influenced	/film/film/dubbing_performances./film/dubbing_performance/character	554
['/base/americancomedy/comedian/comedy_genres', '/genre']	/base/americancomedy/comedian/comedy_genres	/base/popstra/celebrity/friendship./base/popstra/friendship/participant	917
['/film/actor/film./film/performance/special_performance_type', '/occupation']	/film/actor/film./film/performance/special_performance_type	/base/popstra/celebrity/breakup./base/popstra/breakup/participant	664
['/location/location/partially_contains', '/largestCity']	/location/location/partially_contains	/business/employer/employees./business/employment_tenure/person	15
['/film/film/prequel', 'df-schema#seeAlso']	/film/film/prequel	/government/government_office_or_title/category	1000
['/government/governmental_jurisdiction/government_positions', '/leaderTitle']	/government/governmental_jurisdiction/government_positions	/education/educational_institution/sexes_accepted./education/gender_enrollment/sex	1075
['/people/person/employment_history./business/employment_tenure/title', '/position']	/people/person/employment_history./business/employment_tenure/title	/base/activism/activism_issue/activist_organizations	283
['/ice_hockey/hockey_player/current_team./ice_hockey/hockey_roster_position/position', '/position']	/ice_hockey/hockey_player/current_team./ice_hockey/hockey_roster_position/position	/base/activism/activism_issue/activist_organizations	336
['/tv/tv_series_episode/writer', '/writer']	/tv/tv_series_episode/writer	/sports/sports_league/sport	759
['/computer/software_developer/software', '/product']	/computer/software_developer/software	/book/written_work/subjects	1020
['/american_football/football_player/former_teams./american_football/football_historical_roster_position/position_s', '/position']	/american_football/football_player/former_teams./american_football/football_historical_roster_position/position_s	/base/activism/activism_issue/activist_organizations	1565
['/business/business_operation/assets./measurement_unit/dated_money_value/currency', '/revenue']	/business/business_operation/assets./measurement_unit/dated_money_value/currency	/food/dish/ingredients	1466
['/film/cinematographer/film', '/award']	/film/cinematographer/film	/relative	1190
['/base/schemastaging/organization_extra/phone_number./base/schemastaging/phone_sandbox/service_location', '/locationCountry']	/base/schemastaging/organization_extra/phone_number./base/schemastaging/phone_sandbox/service_location	/country	1000
['/media_common/adapted_work/adaptations', '/subsequentWork']	/media_common/adapted_work/adaptations	/baseball/baseball_team/current_roster./baseball/baseball_roster_position/position	93
['/government/political_party/politicians_in_this_party./government/political_party_tenure/politician', '/leader']	/government/political_party/politicians_in_this_party./government/political_party_tenure/politician	/jr/sr	1116
['/film/film/story_by', '/writer']	/film/film/story_by	/sports/sports_league/sport	1031
['/film/film/music', '/musicComposer']	/film/film/music	/broadcast/distributor/distributes	526
['/people/person/spouse_s./people/marriage/spouse', '/spouse']	/people/person/spouse_s./people/marriage/spouse	/formerBandMember	473
['/media_common/media_genre/parent_genre', '/genre']	/media_common/media_genre/parent_genre	/base/popstra/celebrity/friendship./base/popstra/friendship/participant	1539
['/computer/operating_system_developer/operating_systems_developed', '/product']	/computer/operating_system_developer/operating_systems_developed	/book/written_work/subjects	733
['/tv/tv_program/spin_offs', '/related']	/tv/tv_program/spin_offs	/base/saints/saint/venerated_in	345
['/organization/organization/leadership./organization/leadership/role', '/keyPerson']	/organization/organization/leadership./organization/leadership/role	/people/deceased_person/place_of_death	444
['/location/statistical_region/gni_in_ppp_dollars./measurement_unit/dated_money_value/currency', '/currency']	/location/statistical_region/gni_in_ppp_dollars./measurement_unit/dated_money_value/currency	/olympics/olympic_athlete/medals_won./olympics/olympic_medal_honor/country	329
['/time/event/locations', '/place']	/time/event/locations	/education/academic_institution/visiting_scholars_fellows_etc./education/academic_post/person	380
['/ice_hockey/hockey_player/current_team./sports/sports_team_roster/team', '/formerTeams']	/ice_hockey/hockey_player/current_team./sports/sports_team_roster/team	/governmentType	72
['/sports/pro_athlete/teams./basketball/basketball_roster_position/team', '/team']	/sports/pro_athlete/teams./basketball/basketball_roster_position/team	/book/periodical_subject/periodicals	413
['/soccer/football_player/current_team./soccer/football_roster_position/team', '/team']	/soccer/football_player/current_team./soccer/football_roster_position/team	/book/periodical_subject/periodicals	640
['/base/popstra/celebrity/dated./base/popstra/dated/participant', '/spouse']	/base/popstra/celebrity/dated./base/popstra/dated/participant	/formerBandMember	683
['/business/business_operation/liabilities./measurement_unit/dated_money_value/currency', '/revenue']	/business/business_operation/liabilities./measurement_unit/dated_money_value/currency	/food/dish/ingredients	1127
['/american_football/football_player/current_team./sports/sports_team_roster/team', '/formerTeam']	/american_football/football_player/current_team./sports/sports_team_roster/team	/medicine/icd_9_cm_classification/parent_classification	1454
['/film/film/production_companies', '/distributor']	/film/film/production_companies	/award/award_category/winners./award/award_honor/award_winner	817
['/location/statistical_region/rent50_3./measurement_unit/dated_money_value/currency', '/currency']	/location/statistical_region/rent50_3./measurement_unit/dated_money_value/currency	/olympics/olympic_athlete/medals_won./olympics/olympic_medal_honor/country	1103
['/aviation/airline/hubs', '/hubAirport']	/aviation/airline/hubs	/government/legislative_session/members./government/government_position_held/basic_title	1177
['/tv/tv_series_episode/guest_stars./tv/tv_guest_role/actor', '/starring']	/tv/tv_series_episode/guest_stars./tv/tv_guest_role/actor	/genre	1377
['/government/governmental_body/component_bodies', '/house']	/government/governmental_body/component_bodies	/religion/religion/deities	1350
['/people/ethnicity/languages_spoken', '/language']	/people/ethnicity/languages_spoken	/base/eating/diets/people_who_follow_this_diet	1038
['/fictional_universe/work_of_fiction/part_of_these_fictional_universes', '/basedOn']	/fictional_universe/work_of_fiction/part_of_these_fictional_universes	/government/politician/government_positions_held./government/government_position_held/legislative_sessions	429
['/base/thoroughbredracing/thoroughbred_racehorse/color', '/colour']	/base/thoroughbredracing/thoroughbred_racehorse/color	/music/artist/supporting_artists	1543
['/organization/organization_member/member_of./organization/organization_membership/organization', '/affiliation']	/organization/organization_member/member_of./organization/organization_membership/organization	/location/country/second_level_divisions	206
['/soccer/football_team_manager/team./soccer/football_team_management_tenure/team', '/managerClub']	/soccer/football_team_manager/team./soccer/football_team_management_tenure/team	/religion/religious_text/religious_text_of	1168
['/computer/computer/manufacturer', '/manufacturer']	/computer/computer/manufacturer	/sports/sports_position/players./soccer/football_roster_position/team	426
['/business/consumer_company/products./business/company_product_relationship/consumer_product', '/product']	/business/consumer_company/products./business/company_product_relationship/consumer_product	/book/written_work/subjects	1180
['/film/film/country', '/country']	/film/film/country	/locationCountry	908
['/film/film/distributors./film/film_film_distributor_relationship/region', '/country']	/film/film/distributors./film/film_film_distributor_relationship/region	/locationCountry	833
['/transportation/road/major_cities', '/routeJunction']	/transportation/road/major_cities	/baseball/baseball_player/batting_stats./baseball/batting_statistics/team	1337
['/broadcast/artist/content', '/genre']	/broadcast/artist/content	/base/popstra/celebrity/friendship./base/popstra/friendship/participant	196
['/travel/tourist_attraction/near_travel_destination', '/location']	/travel/tourist_attraction/near_travel_destination	/protected_sites/site_listing_category/listed_sites./protected_sites/natural_or_cultural_site_listing/listed_site	1552
['/business/consumer_company/brands./business/company_brand_relationship/brand', '/division']	/business/consumer_company/brands./business/company_brand_relationship/brand	/base/aareas/schema/administrative_area/capital	1226
['/computer/programming_language/dialects', '/influenced']	/computer/programming_language/dialects	/film/film/dubbing_performances./film/dubbing_performance/character	905
['/sports/pro_athlete/teams./basketball/basketball_historical_roster_position/team', '/team']	/sports/pro_athlete/teams./basketball/basketball_historical_roster_position/team	/book/periodical_subject/periodicals	1005
['/award/award_category/presenting_organization', '/presenter']	/award/award_category/presenting_organization	/house	1350
['/book/newspaper/owner', '/owner']	/book/newspaper/owner	/colors	1251
['/base/nobelprizes/nobel_prize_winner/nobel_honor./base/nobelprizes/nobel_honor/subject_area', '/deathPlace']	/base/nobelprizes/nobel_prize_winner/nobel_honor./base/nobelprizes/nobel_honor/subject_area	/fictional_universe/fictional_character/place_of_birth	669
['/organization/organization/geographic_scope', '/country']	/organization/organization/geographic_scope	/locationCountry	1323
['/american_football/football_coach/coaching_history./american_football/football_historical_coach_position/position', '/position']	/american_football/football_coach/coaching_history./american_football/football_historical_coach_position/position	/base/activism/activism_issue/activist_organizations	19
['/government/political_party/ideology', '/ideology']	/government/political_party/ideology	/programmeFormat	112
['/tv/tv_character/appeared_in_tv_episodes./tv/tv_guest_role/actor', '/portrayer']	/tv/tv_character/appeared_in_tv_episodes./tv/tv_guest_role/actor	/base/popstra/celebrity/vacations_in./base/popstra/vacation_choice/location	131
['/user/ktrueman/default_domain/international_organization/member_states', '/headquarter']	/user/ktrueman/default_domain/international_organization/member_states	/martial_arts/martial_artist/martial_art	951
['/tv/tv_program/recurring_writers./tv/tv_program_writer_relationship/writer', '/executiveProducer']	/tv/tv_program/recurring_writers./tv/tv_program_writer_relationship/writer	/film/film_character/portrayed_in_films./film/performance/actor	836
['/baseball/baseball_player/current_team./baseball/baseball_roster_position/team', '/team']	/baseball/baseball_player/current_team./baseball/baseball_roster_position/team	/book/periodical_subject/periodicals	280
['/sports/sports_team/roster./soccer/football_roster_position/player', '/name']	/sports/sports_team/roster./soccer/football_roster_position/player	/base/contractbridge/bridge_player/second_place_finish./base/contractbridge/bridge_tournament_standings/first_place	442
['/location/neighborhood/neighborhood_of', '/isPartOf']	/location/neighborhood/neighborhood_of	/american_football/football_player/games./american_football/player_game_statistics/team	819
['/architecture/structure/architectural_style', '/architecturalStyle']	/architecture/structure/architectural_style	/organization/endowed_organization/endowment./measurement_unit/dated_money_value/currency	1174
['/military/military_combatant/military_conflicts./military/military_combatant_group/conflict', 'df-schema#seeAlso']	/military/military_combatant/military_conflicts./military/military_combatant_group/conflict	/government/government_office_or_title/category	84
['/film/film/film_production_design_by', '/editing']	/film/film/film_production_design_by	/award/award_category/winners./award/award_honor/ceremony	1282
['/basketball/basketball_player/player_statistics./basketball/basketball_player_stats/team', '/team']	/basketball/basketball_player/player_statistics./basketball/basketball_player_stats/team	/book/periodical_subject/periodicals	460
['/sports/pro_athlete/teams./sports/sports_team_roster/position', '/position']	/sports/pro_athlete/teams./sports/sports_team_roster/position	/base/activism/activism_issue/activist_organizations	1211
['/location/location/time_zones', '/timeZone']	/location/location/time_zones	/fictional_universe/person_in_fiction/representations_in_fiction	129
['/sports/sports_team/league./sports/sports_league_participation/league', '/league']	/sports/sports_team/league./sports/sports_league_participation/league	/base/locations/countries/continent	1051
['/film/film/language', '/language']	/film/film/language	/base/eating/diets/people_who_follow_this_diet	1457
['/broadcast/radio_station/format', '/programmeFormat']	/broadcast/radio_station/format	/fictional_universe/work_of_fiction/part_of_these_fictional_universes	256
['/education/academic/appointments_fellowships_etc./education/academic_post/institution', '/almaMater']	/education/academic/appointments_fellowships_etc./education/academic_post/institution	/education	983
['/aviation/aircraft_manufacturer/aircraft_models_made', '/product']	/aviation/aircraft_manufacturer/aircraft_models_made	/book/written_work/subjects	264
['/film/film_character/portrayed_in_films./film/performance/actor', '/voice']	/film/film_character/portrayed_in_films./film/performance/actor	/base/fashionmodels/hair_color/fashion_models_with_this_hair_color	1347
['/aviation/airline/airports_served./aviation/airline_airport_presence/airport', '/hubAirport']	/aviation/airline/airports_served./aviation/airline_airport_presence/airport	/government/legislative_session/members./government/government_position_held/basic_title	238
['/government/governmental_body/jurisdiction', '/location']	/government/governmental_body/jurisdiction	/protected_sites/site_listing_category/listed_sites./protected_sites/natural_or_cultural_site_listing/listed_site	1087
['/sports/pro_athlete/teams./baseball/baseball_roster_position/team', '/team']	/sports/pro_athlete/teams./baseball/baseball_roster_position/team	/book/periodical_subject/periodicals	886
['/base/popstra/celebrity/supporter./base/popstra/support/supported_organization', '/party']	/base/popstra/celebrity/supporter./base/popstra/support/supported_organization	/tv/tv_writer/tv_programs./tv/tv_program_writer_relationship/tv_program	1352
['/fictional_universe/fictional_character/species', '/species']	/fictional_universe/fictional_character/species	/olympics/olympic_medal/medal_winners./olympics/olympic_medal_honor/olympics	1142
['/government/politician/party./government/political_party_tenure/party', '/party']	/government/politician/party./government/political_party_tenure/party	/tv/tv_writer/tv_programs./tv/tv_program_writer_relationship/tv_program	131
['/tv/tv_producer/programs_produced./tv/tv_producer_term/producer_type', '/occupation']	/tv/tv_producer/programs_produced./tv/tv_producer_term/producer_type	/base/popstra/celebrity/breakup./base/popstra/breakup/participant	1349
['/award/award_winner/awards_won./award/award_honor/honored_for', '/award']	/award/award_winner/awards_won./award/award_honor/honored_for	/relative	1221
['/business/consumer_product/company./business/company_product_relationship/company', '/developer']	/business/consumer_product/company./business/company_product_relationship/company	/medicine/disease/risk_factors	1505
['/location/capital_of_administrative_division/capital_of./location/administrative_division_capital_relationship/administrative_division', '/isPartOf']	/location/capital_of_administrative_division/capital_of./location/administrative_division_capital_relationship/administrative_division	/american_football/football_player/games./american_football/player_game_statistics/team	1242
['/education/educational_institution/students_graduates./education/education/degree', '/type']	/education/educational_institution/students_graduates./education/education/degree	/base/localfood/produce/availability./base/localfood/produce_availability/seasonal_months	1249
['/film/actor/film./film/performance/film', '/award']	/film/actor/film./film/performance/film	/relative	1499
['/language/human_language/language_family', 'df-schema#seeAlso']	/language/human_language/language_family	/government/government_office_or_title/category	1251
['/location/country/official_language', '/language']	/location/country/official_language	/base/eating/diets/people_who_follow_this_diet	576
['/education/educational_degree/people_with_this_degree./education/education/major_field_of_study', 'df-schema#seeAlso']	/education/educational_degree/people_with_this_degree./education/education/major_field_of_study	/government/government_office_or_title/category	141
['/location/location/contains', '/largestCity']	/location/location/contains	/business/employer/employees./business/employment_tenure/person	283
['/location/statistical_region/rent50_2./measurement_unit/dated_money_value/currency', '/currency']	/location/statistical_region/rent50_2./measurement_unit/dated_money_value/currency	/olympics/olympic_athlete/medals_won./olympics/olympic_medal_honor/country	883
['/book/author/works_written', '/notableWork']	/book/author/works_written	/base/localfood/food_producing_region/seasonal_availability./base/localfood/produce_availability/produce	1552
['/basketball/basketball_player/team./basketball/basketball_roster_position/position', '/position']	/basketball/basketball_player/team./basketball/basketball_roster_position/position	/base/activism/activism_issue/activist_organizations	1215
['/government/politician/government_positions_held./government/government_position_held/district_represented', '/region']	/government/politician/government_positions_held./government/government_position_held/district_represented	/sports/pro_athlete/teams./basketball/basketball_roster_position/team	624
['/music/record_label/artist', '/founder']	/music/record_label/artist	/location/statistical_region/rent50_4./measurement_unit/dated_money_value/currency	1496
['/people/person/place_of_birth', '/birthPlace']	/people/person/place_of_birth	/cvg/game_series/games_in_series	867
['/government/governmental_body/members./government/government_position_held/jurisdiction_of_office', '/location']	/government/governmental_body/members./government/government_position_held/jurisdiction_of_office	/protected_sites/site_listing_category/listed_sites./protected_sites/natural_or_cultural_site_listing/listed_site	1011
['/soccer/football_team/current_roster./soccer/football_roster_position/player', '/name']	/soccer/football_team/current_roster./soccer/football_roster_position/player	/base/contractbridge/bridge_player/second_place_finish./base/contractbridge/bridge_tournament_standings/first_place	352
['/government/governmental_body/body_this_is_a_component_of', '/isPartOf']	/government/governmental_body/body_this_is_a_component_of	/american_football/football_player/games./american_football/player_game_statistics/team	821
['/people/deceased_person/place_of_cremation', '/deathPlace']	/people/deceased_person/place_of_cremation	/fictional_universe/fictional_character/place_of_birth	1226
['/music/artist/genre', '/genre']	/music/artist/genre	/base/popstra/celebrity/friendship./base/popstra/friendship/participant	865
['/base/culturalevent/event/entity_involved', '/commander']	/base/culturalevent/event/entity_involved	/medicine/condition_prevention_factors/conditions_this_may_prevent	497
['/award/award/presented_by', '/presenter']	/award/award/presented_by	/house	1259
['/ice_hockey/hockey_player/current_team./sports/sports_team_roster/position', '/position']	/ice_hockey/hockey_player/current_team./sports/sports_team_roster/position	/base/activism/activism_issue/activist_organizations	1443
['/basketball/basketball_player/team./sports/sports_team_roster/position', '/position']	/basketball/basketball_player/team./sports/sports_team_roster/position	/base/activism/activism_issue/activist_organizations	896
['/government/political_appointer/appointees./government/government_position_held/office_holder', '/successor']	/government/political_appointer/appointees./government/government_position_held/office_holder	/office	734
['/sports/sports_team/arena_stadium', '/ground']	/sports/sports_team/arena_stadium	/spokenIn	1459
['/medicine/drug_ingredient/active_moiety_of_drug', 'df-schema#seeAlso']	/medicine/drug_ingredient/active_moiety_of_drug	/government/government_office_or_title/category	1429
['/government/governmental_jurisdiction/governing_officials./government/government_position_held/office_position_or_title', '/leaderTitle']	/government/governmental_jurisdiction/governing_officials./government/government_position_held/office_position_or_title	/education/educational_institution/sexes_accepted./education/gender_enrollment/sex	905
['/sports/pro_athlete/teams./american_football/football_roster_position/team', '/formerTeam']	/sports/pro_athlete/teams./american_football/football_roster_position/team	/medicine/icd_9_cm_classification/parent_classification	982
['/ice_hockey/hockey_player/current_team./ice_hockey/hockey_roster_position/team', '/formerTeams']	/ice_hockey/hockey_player/current_team./ice_hockey/hockey_roster_position/team	/governmentType	157
['/user/szaijan/fantasy_football/player/nfl_team', '/formerTeam']	/user/szaijan/fantasy_football/player/nfl_team	/medicine/icd_9_cm_classification/parent_classification	50
['/music/album/genre', '/genre']	/music/album/genre	/base/popstra/celebrity/friendship./base/popstra/friendship/participant	922
['/broadcast/content/location', '/city']	/broadcast/content/location	/baseball/baseball_team/league	1077
['/sports/pro_athlete/teams./ice_hockey/hockey_previous_roster_position/team', '/formerTeams']	/sports/pro_athlete/teams./ice_hockey/hockey_previous_roster_position/team	/governmentType	850
['/people/ethnicity/geographic_distribution', '/populationPlace']	/people/ethnicity/geographic_distribution	/government/government_office_or_title/category	392
['/location/statistical_region/rent50_0./measurement_unit/dated_money_value/currency', '/currency']	/location/statistical_region/rent50_0./measurement_unit/dated_money_value/currency	/olympics/olympic_athlete/medals_won./olympics/olympic_medal_honor/country	627
['/business/business_operation/current_liabilities./measurement_unit/dated_money_value/currency', '/revenue']	/business/business_operation/current_liabilities./measurement_unit/dated_money_value/currency	/food/dish/ingredients	1047
['/tv/tv_actor/guest_roles./tv/tv_guest_role/special_performance_type', '/occupation']	/tv/tv_actor/guest_roles./tv/tv_guest_role/special_performance_type	/base/popstra/celebrity/breakup./base/popstra/breakup/participant	1201
['/soccer/football_player/current_team./sports/sports_team_roster/team', '/team']	/soccer/football_player/current_team./sports/sports_team_roster/team	/book/periodical_subject/periodicals	1170
['/visual_art/visual_artist/art_forms', '/field']	/visual_art/visual_artist/art_forms	/position	780
['/government/political_appointer/appointees./government/government_position_held/jurisdiction_of_office', '/country']	/government/political_appointer/appointees./government/government_position_held/jurisdiction_of_office	/locationCountry	307
['/american_football/football_player/former_teams./american_football/football_historical_roster_position/team', '/formerTeam']	/american_football/football_player/former_teams./american_football/football_historical_roster_position/team	/medicine/icd_9_cm_classification/parent_classification	665
['/geography/island_group/islands_in_group', 'df-schema#seeAlso']	/geography/island_group/islands_in_group	/government/government_office_or_title/category	1179
['/people/person/parents', '/parent']	/people/person/parents	/people/appointer/appointment_made./people/appointment/appointed_role	1485
['/film/film/produced_by', '/producer']	/film/film/produced_by	/base/popstra/celebrity/supporter./base/popstra/support/supported_organization	935
['/media_common/media_genre/child_genres', 'df-schema#seeAlso']	/media_common/media_genre/child_genres	/government/government_office_or_title/category	1549
['/location/statistical_region/gdp_nominal_per_capita./measurement_unit/dated_money_value/currency', '/currency']	/location/statistical_region/gdp_nominal_per_capita./measurement_unit/dated_money_value/currency	/olympics/olympic_athlete/medals_won./olympics/olympic_medal_honor/country	395
['/music/group_member/membership./music/group_membership/role', '/instrument']	/music/group_member/membership./music/group_membership/role	/base/folklore/mythical_creature/mythology	313
['/organization/organization/headquarters./location/mailing_address/citytown', '/city']	/organization/organization/headquarters./location/mailing_address/citytown	/baseball/baseball_team/league	167
['/people/person/ethnicity', '/nationality']	/people/person/ethnicity	/government/governmental_jurisdiction/governing_officials./government/government_position_held/basic_title	1052
['/film/editor/film', '/award']	/film/editor/film	/relative	1455
['/government/government_office_or_title/jurisdiction', 'df-schema#seeAlso']	/government/government_office_or_title/jurisdiction	/government/government_office_or_title/category	821
['/film/film/written_by', '/writer']	/film/film/written_by	/sports/sports_league/sport	1474
['/military/military_conflict/casualties./military/casualties/combatant', '/place']	/military/military_conflict/casualties./military/casualties/combatant	/education/academic_institution/visiting_scholars_fellows_etc./education/academic_post/person	579
['/tv/tv_writer/tv_programs./tv/tv_program_writer_relationship/tv_program', '/notableWork']	/tv/tv_writer/tv_programs./tv/tv_program_writer_relationship/tv_program	/base/localfood/food_producing_region/seasonal_availability./base/localfood/produce_availability/produce	614
['/location/location/street_address./location/mailing_address/state_province_region', '/state']	/location/location/street_address./location/mailing_address/state_province_region	/government/governmental_jurisdiction/governing_officials./government/government_position_held/governmental_body	1532
['/royalty/monarch/kingdom', '/birthPlace']	/royalty/monarch/kingdom	/cvg/game_series/games_in_series	1523
['/american_football/football_player/current_team./american_football/football_roster_position/position', '/position']	/american_football/football_player/current_team./american_football/football_roster_position/position	/base/activism/activism_issue/activist_organizations	1116
['/organization/organization/leadership./organization/leadership/person', '/keyPerson']	/organization/organization/leadership./organization/leadership/person	/people/deceased_person/place_of_death	1181
['/award/award_winning_work/awards_won./award/award_honor/honored_for', 'df-schema#seeAlso']	/award/award_winning_work/awards_won./award/award_honor/honored_for	/government/government_office_or_title/category	612
['/people/deceased_person/cause_of_death', '/deathCause']	/people/deceased_person/cause_of_death	/baseball/baseball_player/former_teams./baseball/baseball_historical_roster_position/team	1084
['/fictional_universe/fictional_character/character_created_by', '/creator']	/fictional_universe/fictional_character/character_created_by	/director	1430
['/olympics/olympic_athlete/country./olympics/olympic_athlete_affiliation/country', '/birthPlace']	/olympics/olympic_athlete/country./olympics/olympic_athlete_affiliation/country	/cvg/game_series/games_in_series	975
['/tv/tv_character/appeared_in_tv_program./tv/regular_tv_appearance/actor', '/portrayer']	/tv/tv_character/appeared_in_tv_program./tv/regular_tv_appearance/actor	/base/popstra/celebrity/vacations_in./base/popstra/vacation_choice/location	186
['/tv/tv_network/areas_served', '/country']	/tv/tv_network/areas_served	/locationCountry	857
['/sports/pro_athlete/teams./ice_hockey/hockey_roster_position/team', '/formerTeams']	/sports/pro_athlete/teams./ice_hockey/hockey_roster_position/team	/governmentType	286
['/baseball/baseball_player/position_s', '/position']	/baseball/baseball_player/position_s	/base/activism/activism_issue/activist_organizations	1505
['/transportation/road/end1./transportation/road_starting_point/location', '/routeEnd']	/transportation/road/end1./transportation/road_starting_point/location	/royalty/noble_person/titles./royalty/noble_title_tenure/noble_title	1343
['/government/political_district/representatives./government/government_position_held/jurisdiction_of_office', '/country']	/government/political_district/representatives./government/government_position_held/jurisdiction_of_office	/locationCountry	685
['/education/educational_institution/mascot', '/mascot']	/education/educational_institution/mascot	/tv/tv_producer_type/tv_producers_of_this_type./tv/tv_producer_term/producer	622
['/government/governmental_jurisdiction/governing_officials./government/government_position_held/office_holder', '/leaderName']	/government/governmental_jurisdiction/governing_officials./government/government_position_held/office_holder	/biology/animal_breed/registered_with./biology/breed_registration/registry	683
['/transportation/bridge/bridge_type', '/design']	/transportation/bridge/bridge_type	/computer/software/license	423
['/cvg/computer_videogame/publisher', '/publisher']	/cvg/computer_videogame/publisher	/user/robert/military/military_person/participated_in_conflicts	747
['/american_football/football_player/former_teams./sports/sports_team_roster/position', '/position']	/american_football/football_player/former_teams./sports/sports_team_roster/position	/base/activism/activism_issue/activist_organizations	1283
['/film/film/featured_film_locations', '/country']	/film/film/featured_film_locations	/locationCountry	1579
['/broadcast/broadcast/area_served', '/country']	/broadcast/broadcast/area_served	/locationCountry	270
['/business/business_operation/operating_income./measurement_unit/dated_money_value/currency', '/revenue']	/business/business_operation/operating_income./measurement_unit/dated_money_value/currency	/food/dish/ingredients	444
['/visual_art/visual_artist/associated_periods_or_movements', '/movement']	/visual_art/visual_artist/associated_periods_or_movements	/base/marchmadness/ncaa_basketball_team/ncaa_tournament_seeds./base/marchmadness/ncaa_tournament_seed/tournament	1091
['/transportation/bridge/locale', '/locatedInArea']	/transportation/bridge/locale	/tv/tv_personality/tv_regular_appearances./tv/tv_regular_personal_appearance/program	85
['/base/aareas/schema/administrative_area/administrative_parent', '/country']	/base/aareas/schema/administrative_area/administrative_parent	/locationCountry	977
['/education/educational_institution/campuses', '/campus']	/education/educational_institution/campuses	/cvg/computer_videogame/developer	1277
['/people/person/children', '/child']	/people/person/children	/aviation/aircraft_owner/aircraft_fleet_composition./aviation/aircraft_ownership_count/aircraft_model	165
['/computer/software/developer', '/developer']	/computer/software/developer	/medicine/disease/risk_factors	1205
['/organization/organization/involved_in_merger./organization/organization_merger/became_organization', '/successor']	/organization/organization/involved_in_merger./organization/organization_merger/became_organization	/office	69
['/military/armed_force/personnel./military/military_service/military_person', '/notableCommander']	/military/armed_force/personnel./military/military_service/military_person	/sports/drafted_athlete/drafted./sports/sports_league_draft_pick/school	784
['/american_football/football_player/passing./american_football/player_passing_statistics/team', '/formerTeam']	/american_football/football_player/passing./american_football/player_passing_statistics/team	/medicine/icd_9_cm_classification/parent_classification	856
['/base/aareas/schema/administrative_area/capital', '/capital']	/base/aareas/schema/administrative_area/capital	/tv/tv_program_guest/appeared_on./tv/tv_guest_personal_appearance/appearance_type	107
['/base/popstra/celebrity/canoodled./base/popstra/canoodled/participant', '/spouse']	/base/popstra/celebrity/canoodled./base/popstra/canoodled/participant	/formerBandMember	97
['/american_football/football_player/position_s', '/position']	/american_football/football_player/position_s	/base/activism/activism_issue/activist_organizations	70
['/sports/pro_athlete/teams./ice_hockey/hockey_roster_position/position', '/position']	/sports/pro_athlete/teams./ice_hockey/hockey_roster_position/position	/base/activism/activism_issue/activist_organizations	293
['/comic_books/comic_book_series/publisher', '/publisher']	/comic_books/comic_book_series/publisher	/user/robert/military/military_person/participated_in_conflicts	328
['/soccer/football_player/current_team./soccer/football_roster_position/position', '/position']	/soccer/football_player/current_team./soccer/football_roster_position/position	/base/activism/activism_issue/activist_organizations	860
['/medicine/drug/active_moieties', 'df-schema#seeAlso']	/medicine/drug/active_moieties	/government/government_office_or_title/category	81
['/business/employer/employees./business/employment_tenure/person', '/keyPerson']	/business/employer/employees./business/employment_tenure/person	/people/deceased_person/place_of_death	705
['/common/topic/webpage./common/webpage/resource', '/director']	/common/topic/webpage./common/webpage/resource	/military/military_person/participated_in_conflicts	578
['/base/famouspets/pet_owner/pets_owned./base/famouspets/pet_ownership/owner', '/spouse']	/base/famouspets/pet_owner/pets_owned./base/famouspets/pet_ownership/owner	/formerBandMember	1318
['/tv/tv_program_creator/programs_created', '/notableWork']	/tv/tv_program_creator/programs_created	/base/localfood/food_producing_region/seasonal_availability./base/localfood/produce_availability/produce	1502
['/film/film/starring./film/performance/actor', '/starring']	/film/film/starring./film/performance/actor	/genre	414
['/location/administrative_division/capital./location/administrative_division_capital_relationship/capital', '/countySeat']	/location/administrative_division/capital./location/administrative_division_capital_relationship/capital	/business/asset_owner/assets_owned./business/asset_ownership/owned_asset	1089
['/medicine/notable_person_with_medical_condition/condition', '/deathCause']	/medicine/notable_person_with_medical_condition/condition	/baseball/baseball_player/former_teams./baseball/baseball_historical_roster_position/team	141
['/location/administrative_division/first_level_division_of', '/country']	/location/administrative_division/first_level_division_of	/locationCountry	754
['/tv/tv_actor/starring_roles./tv/regular_tv_appearance/series', '/knownFor']	/tv/tv_actor/starring_roles./tv/regular_tv_appearance/series	/base/locations/countries/continent	750
['/american_football/football_player/rushing./american_football/player_rushing_statistics/team', '/formerTeam']	/american_football/football_player/rushing./american_football/player_rushing_statistics/team	/medicine/icd_9_cm_classification/parent_classification	244
['/people/ethnicity/included_in_group', '/related']	/people/ethnicity/included_in_group	/base/saints/saint/venerated_in	1133
['/organization/organization/board_members./organization/organization_board_membership/role', '/keyPerson']	/organization/organization/board_members./organization/organization_board_membership/role	/people/deceased_person/place_of_death	986
['/location/location/adjoin_s./location/adjoining_relationship/adjoins', 'wl#differentFrom']	/location/location/adjoin_s./location/adjoining_relationship/adjoins	/user/coco/science/concepts_theories/child_concept	196
['/award/award_winning_work/awards_won./award/award_honor/award_winner', '/starring']	/award/award_winning_work/awards_won./award/award_honor/award_winner	/genre	599
['/media_common/dedicated_work/dedication./media_common/dedication/dedicated_to', '/cinematography']	/media_common/dedicated_work/dedication./media_common/dedication/dedicated_to	/aviation/aircraft_model/aircraft_type	55
['/film/film_costumer_designer/costume_design_for_film', '/award']	/film/film_costumer_designer/costume_design_for_film	/relative	744
['/organization/organization/acquired_by./business/acquisition/acquiring_company', '/parentCompany']	/organization/organization/acquired_by./business/acquisition/acquiring_company	/geography/geographical_feature/category	20
['/organization/organization/headquarters./location/mailing_address/state_province_region', '/state']	/organization/organization/headquarters./location/mailing_address/state_province_region	/government/governmental_jurisdiction/governing_officials./government/government_position_held/governmental_body	341
['/language/human_language/countries_spoken_in', '/spokenIn']	/language/human_language/countries_spoken_in	/base/argumentmaps/morally_disputed_activity/instance_of_abstract_moral_dispute	1201
['/film/film/personal_appearances./film/personal_film_appearance/person', '/starring']	/film/film/personal_appearances./film/personal_film_appearance/person	/genre	289
['/symbols/namesake/named_after', '/countySeat']	/symbols/namesake/named_after	/business/asset_owner/assets_owned./business/asset_ownership/owned_asset	682
['/fictional_universe/fictional_character_creator/fictional_characters_created', '/notableWork']	/fictional_universe/fictional_character_creator/fictional_characters_created	/base/localfood/food_producing_region/seasonal_availability./base/localfood/produce_availability/produce	337
['/user/lindenb/default_domain/scientist/known_for', '/mainInterest']	/user/lindenb/default_domain/scientist/known_for	/american_football/football_player/receiving./american_football/player_receiving_statistics/season	1545
['/metropolitan_transit/transit_system/area_served', 'df-schema#seeAlso']	/metropolitan_transit/transit_system/area_served	/government/government_office_or_title/category	950
['/base/schemastaging/organization_extra/phone_number./base/schemastaging/phone_sandbox/product_or_service', '/product']	/base/schemastaging/organization_extra/phone_number./base/schemastaging/phone_sandbox/product_or_service	/book/written_work/subjects	632
['/tv/tv_producer/programs_produced./tv/tv_producer_term/program', '/notableWork']	/tv/tv_producer/programs_produced./tv/tv_producer_term/program	/base/localfood/food_producing_region/seasonal_availability./base/localfood/produce_availability/produce	859
['/government/governmental_body/members./government/government_position_held/district_represented', '/location']	/government/governmental_body/members./government/government_position_held/district_represented	/protected_sites/site_listing_category/listed_sites./protected_sites/natural_or_cultural_site_listing/listed_site	1488
['/education/field_of_study/subdiscipline_of', 'df-schema#seeAlso']	/education/field_of_study/subdiscipline_of	/government/government_office_or_title/category	159
['/award/award_winner/awards_won./award/award_honor/ceremony', '/award']	/award/award_winner/awards_won./award/award_honor/ceremony	/relative	1237
['/military/military_conflict/force_strengths./military/force_strength/combatant', '/place']	/military/military_conflict/force_strengths./military/force_strength/combatant	/education/academic_institution/visiting_scholars_fellows_etc./education/academic_post/person	1518
['/religion/religion/deities', 'df-schema#seeAlso']	/religion/religion/deities	/government/government_office_or_title/category	302
['/sports/pro_athlete/teams./soccer/football_roster_position/team', '/team']	/sports/pro_athlete/teams./soccer/football_roster_position/team	/book/periodical_subject/periodicals	1171
['/award/award_nominee/award_nominations./award/award_nomination/nominated_for', '/award']	/award/award_nominee/award_nominations./award/award_nomination/nominated_for	/relative	1502
['/base/americancomedy/celebrity_impressionist/celebrities_impersonated', '/influences']	/base/americancomedy/celebrity_impressionist/celebrities_impersonated	/music/album/artist	904
['/government/governmental_body/members./government/government_position_held/office_holder', '/leader']	/government/governmental_body/members./government/government_position_held/office_holder	/jr/sr	1538
['/film/film/gross_revenue./measurement_unit/dated_money_value/currency', '/country']	/film/film/gross_revenue./measurement_unit/dated_money_value/currency	/locationCountry	1117
['/people/person/employment_history./business/employment_tenure/company', '/country']	/people/person/employment_history./business/employment_tenure/company	/locationCountry	524
['/baseball/baseball_player/batting_stats./baseball/batting_statistics/team', '/debutTeam']	/baseball/baseball_player/batting_stats./baseball/batting_statistics/team	/media_common/dedicated_work/dedication./media_common/dedication/dedicated_to	718
['/travel/transport_terminus/travel_destinations_served./travel/transportation/travel_destination', '/city']	/travel/transport_terminus/travel_destinations_served./travel/transportation/travel_destination	/baseball/baseball_team/league	454
['/tv/tv_program/regular_personal_appearances./tv/tv_regular_personal_appearance/person', '/judges']	/tv/tv_program/regular_personal_appearances./tv/tv_regular_personal_appearance/person	/film/personal_film_appearance_type/film_appearances./film/personal_film_appearance/film	653
['/organization/organization/sectors', '/ideology']	/organization/organization/sectors	/programmeFormat	1315
['/tv/tv_actor/starring_roles./tv/regular_tv_appearance/character', '/knownFor']	/tv/tv_actor/starring_roles./tv/regular_tv_appearance/character	/base/locations/countries/continent	1075
['/computer/programming_language/language_paradigms', 'df-schema#seeAlso']	/computer/programming_language/language_paradigms	/government/government_office_or_title/category	637
['/media_common/dedicator/dedications./media_common/dedication/dedicated_to', 'df-schema#seeAlso']	/media_common/dedicator/dedications./media_common/dedication/dedicated_to	/government/government_office_or_title/category	339
['/music/artist/track_contributions./music/track_contribution/role', '/instrument']	/music/artist/track_contributions./music/track_contribution/role	/base/folklore/mythical_creature/mythology	1478
['/location/country/form_of_government', '/governmentType']	/location/country/form_of_government	/music/artist/supporting_artists	264
['/language/human_language/main_country', '/spokenIn']	/language/human_language/main_country	/base/argumentmaps/morally_disputed_activity/instance_of_abstract_moral_dispute	81
['/location/statistical_region/rent50_1./measurement_unit/dated_money_value/currency', '/currency']	/location/statistical_region/rent50_1./measurement_unit/dated_money_value/currency	/olympics/olympic_athlete/medals_won./olympics/olympic_medal_honor/country	708
['/base/schemastaging/athlete_extra/salary./base/schemastaging/athlete_salary/team', '/team']	/base/schemastaging/athlete_extra/salary./base/schemastaging/athlete_salary/team	/book/periodical_subject/periodicals	723
['/organization/organization/headquarters./location/mailing_address/country', '/country']	/organization/organization/headquarters./location/mailing_address/country	/locationCountry	1127
['/government/governmental_jurisdiction/governing_officials./government/government_position_held/appointed_by', '/leaderName']	/government/governmental_jurisdiction/governing_officials./government/government_position_held/appointed_by	/biology/animal_breed/registered_with./biology/breed_registration/registry	1261
['/government/politician/government_positions_held./government/government_position_held/jurisdiction_of_office', '/country']	/government/politician/government_positions_held./government/government_position_held/jurisdiction_of_office	/locationCountry	261
['/religion/religious_organization/associated_with', 'df-schema#seeAlso']	/religion/religious_organization/associated_with	/government/government_office_or_title/category	798
['/location/country/first_level_divisions', '/capital']	/location/country/first_level_divisions	/tv/tv_program_guest/appeared_on./tv/tv_guest_personal_appearance/appearance_type	701
['/broadcast/content/producer', '/company']	/broadcast/content/producer	/soccer/football_player/current_team./sports/sports_team_roster/team	940
['/military/military_commander/military_commands./military/military_command/military_combatant', '/deathPlace']	/military/military_commander/military_commands./military/military_command/military_combatant	/fictional_universe/fictional_character/place_of_birth	377
['/film/film/cinematography', '/cinematography']	/film/film/cinematography	/aviation/aircraft_model/aircraft_type	559
['/business/employer/employees./business/employment_tenure/title', '/keyPerson']	/business/employer/employees./business/employment_tenure/title	/people/deceased_person/place_of_death	1002
['/computer/computer_manufacturer_brand/computer_models', '/product']	/computer/computer_manufacturer_brand/computer_models	/book/written_work/subjects	268
['/american_football/football_player/games./american_football/player_game_statistics/team', '/formerTeam']	/american_football/football_player/games./american_football/player_game_statistics/team	/medicine/icd_9_cm_classification/parent_classification	490
['/film/film/edited_by', '/editing']	/film/film/edited_by	/award/award_category/winners./award/award_honor/ceremony	1217
['/location/country/languages_spoken', '/language']	/location/country/languages_spoken	/base/eating/diets/people_who_follow_this_diet	364
['/film/music_contributor/film', '/award']	/film/music_contributor/film	/relative	1011
['/film/film_story_contributor/film_story_credits', '/notableWork']	/film/film_story_contributor/film_story_credits	/base/localfood/food_producing_region/seasonal_availability./base/localfood/produce_availability/produce	1294
['/organization/organization/spun_off_from./organization/organization_spin_off/parent_company', '/owner']	/organization/organization/spun_off_from./organization/organization_spin_off/parent_company	/colors	1190
['/aviation/airline/focus_cities', '/hubAirport']	/aviation/airline/focus_cities	/government/legislative_session/members./government/government_position_held/basic_title	102
['/music/group_member/membership./music/group_membership/group', '/associatedBand']	/music/group_member/membership./music/group_membership/group	/music/performance_role/track_performances./music/track_contribution/role	771
['/aviation/airline/alliance', '/alliance']	/aviation/airline/alliance	/base/popstra/celebrity/lived_with./base/popstra/lived_with/participant	892
['/business/board_member/organization_board_memberships./organization/organization_board_membership/organization', '/occupation']	/business/board_member/organization_board_memberships./organization/organization_board_membership/organization	/base/popstra/celebrity/breakup./base/popstra/breakup/participant	6
['/sports/pro_athlete/teams./american_football/football_roster_position/position', '/position']	/sports/pro_athlete/teams./american_football/football_roster_position/position	/base/activism/activism_issue/activist_organizations	854
['/base/popstra/celebrity/religion./base/popstra/religion_choice/religion', '/religion']	/base/popstra/celebrity/religion./base/popstra/religion_choice/religion	/award/award_winning_work/awards_won./award/award_honor/honored_for	1369
['/film/film/costume_design_by', '/editing']	/film/film/costume_design_by	/award/award_category/winners./award/award_honor/ceremony	1143
['/tv/tv_program/program_creator', '/creator']	/tv/tv_program/program_creator	/director	698
['/location/administrative_division/country', '/country']	/location/administrative_division/country	/locationCountry	781
['/book/newspaper/headquarters./location/mailing_address/citytown', '/headquarter']	/book/newspaper/headquarters./location/mailing_address/citytown	/martial_arts/martial_artist/martial_art	1423
['/people/deceased_person/place_of_death', '/deathPlace']	/people/deceased_person/place_of_death	/fictional_universe/fictional_character/place_of_birth	478
['/media_common/adaptation/adapted_from', '/basedOn']	/media_common/adaptation/adapted_from	/government/politician/government_positions_held./government/government_position_held/legislative_sessions	591
['/business/business_operation/industry', '/industry']	/business/business_operation/industry	/cvg/cvg_publisher/games_published	1105
['/film/film_festival/location', '/location']	/film/film_festival/location	/protected_sites/site_listing_category/listed_sites./protected_sites/natural_or_cultural_site_listing/listed_site	625
['/location/country/administrative_divisions', '/capital']	/location/country/administrative_divisions	/tv/tv_program_guest/appeared_on./tv/tv_guest_personal_appearance/appearance_type	581
['/award/award_nominee/award_nominations./award/award_nomination/award', '/award']	/award/award_nominee/award_nominations./award/award_nomination/award	/relative	1356
['/sports/drafted_athlete/drafted./sports/sports_league_draft_pick/team', '/draftTeam']	/sports/drafted_athlete/drafted./sports/sports_league_draft_pick/team	/location/location/time_zones	917
['/sports/pro_athlete/teams./basketball/basketball_roster_position/position', '/position']	/sports/pro_athlete/teams./basketball/basketball_roster_position/position	/base/activism/activism_issue/activist_organizations	668
['/location/statistical_region/gdp_nominal./measurement_unit/dated_money_value/currency', '/currency']	/location/statistical_region/gdp_nominal./measurement_unit/dated_money_value/currency	/olympics/olympic_athlete/medals_won./olympics/olympic_medal_honor/country	419
['/architecture/structure/address./location/mailing_address/citytown', '/location']	/architecture/structure/address./location/mailing_address/citytown	/protected_sites/site_listing_category/listed_sites./protected_sites/natural_or_cultural_site_listing/listed_site	326
['/people/deceased_person/place_of_burial', '/restingPlace']	/people/deceased_person/place_of_burial	/lastAlbum	9
['/organization/organization/board_members./organization/organization_board_membership/member', '/keyPerson']	/organization/organization/board_members./organization/organization_board_membership/member	/people/deceased_person/place_of_death	651
['/film/film_featured_song/performed_by', '/starring']	/film/film_featured_song/performed_by	/genre	1127
['/music/group_member/instruments_played', '/instrument']	/music/group_member/instruments_played	/base/folklore/mythical_creature/mythology	275
['/location/country/second_level_divisions', '/capital']	/location/country/second_level_divisions	/tv/tv_program_guest/appeared_on./tv/tv_guest_personal_appearance/appearance_type	937
['/sports/pro_athlete/teams./baseball/baseball_historical_roster_position/team', '/debutTeam']	/sports/pro_athlete/teams./baseball/baseball_historical_roster_position/team	/media_common/dedicated_work/dedication./media_common/dedication/dedicated_to	429
['/law/inventor/inventions', '/product']	/law/inventor/inventions	/book/written_work/subjects	1145
['/american_football/football_player/current_team./american_football/football_roster_position/team', '/formerTeam']	/american_football/football_player/current_team./american_football/football_roster_position/team	/medicine/icd_9_cm_classification/parent_classification	64
['/base/academyawards/host_of_oscar_show/oscar_show_hosted', '/spouse']	/base/academyawards/host_of_oscar_show/oscar_show_hosted	/formerBandMember	963
['/people/person/places_lived./people/place_lived/location', '/birthPlace']	/people/person/places_lived./people/place_lived/location	/cvg/game_series/games_in_series	938
['/base/thoroughbredracing/thoroughbred_racehorse/country', '/country']	/base/thoroughbredracing/thoroughbred_racehorse/country	/locationCountry	859
['/organization/organization/phone_number./common/phone_number/service_location', '/locationCountry']	/organization/organization/phone_number./common/phone_number/service_location	/country	1138
['/royalty/chivalric_order_member/belongs_to_order./royalty/chivalric_order_membership/order', '/award']	/royalty/chivalric_order_member/belongs_to_order./royalty/chivalric_order_membership/order	/relative	633
['/architecture/museum/address./location/mailing_address/state_province_region', '/location']	/architecture/museum/address./location/mailing_address/state_province_region	/protected_sites/site_listing_category/listed_sites./protected_sites/natural_or_cultural_site_listing/listed_site	1337
['/broadcast/radio_station/owner', '/owner']	/broadcast/radio_station/owner	/colors	1335
['/book/periodical_publisher/periodicals_published./book/periodical_publisher_period/periodical', '/product']	/book/periodical_publisher/periodicals_published./book/periodical_publisher_period/periodical	/book/written_work/subjects	577
['/base/thoroughbredracing/thoroughbred_racehorse/sex', '/sex']	/base/thoroughbredracing/thoroughbred_racehorse/sex	/people/deceased_person/place_of_cremation	1221
['/military/military_conflict/commanders./military/military_command/military_combatant', '/place']	/military/military_conflict/commanders./military/military_command/military_combatant	/education/academic_institution/visiting_scholars_fellows_etc./education/academic_post/person	558
['/religion/religion/is_part_of', 'df-schema#seeAlso']	/religion/religion/is_part_of	/government/government_office_or_title/category	771
['/dataworld/gardening_hint/split_to', '/country']	/dataworld/gardening_hint/split_to	/locationCountry	59
['/user/alexander/philosophy/philosopher/interests', '/mainInterest']	/user/alexander/philosophy/philosopher/interests	/american_football/football_player/receiving./american_football/player_receiving_statistics/season	1139
['/religion/religious_leader/religious_leadership./religion/religious_organization_leadership/organization', '/veneratedIn']	/religion/religious_leader/religious_leadership./religion/religious_organization_leadership/organization	/film/actor/dubbing_performances./film/dubbing_performance/language	1546
['/ice_hockey/hockey_player/former_team_s./ice_hockey/hockey_previous_roster_position/team', '/formerTeams']	/ice_hockey/hockey_player/former_team_s./ice_hockey/hockey_previous_roster_position/team	/governmentType	1284
['/time/event/included_in_event', '/isPartOfMilitaryConflict']	/time/event/included_in_event	/lea	711
['/computer/programming_language/parent_language', '/influencedBy']	/computer/programming_language/parent_language	/architecture/structure/architect	1487
['/base/popstra/celebrity/breakup./base/popstra/breakup/participant', '/spouse']	/base/popstra/celebrity/breakup./base/popstra/breakup/participant	/formerBandMember	1525
['/sports/sports_team/roster./sports/sports_team_roster/player', '/name']	/sports/sports_team/roster./sports/sports_team_roster/player	/base/contractbridge/bridge_player/second_place_finish./base/contractbridge/bridge_tournament_standings/first_place	105
['/broadcast/broadcast/distributor', '/owningCompany']	/broadcast/broadcast/distributor	/language/language_dialect/language	1340
['/sports/pro_athlete/teams./american_football/football_historical_roster_position/team', '/formerTeam']	/sports/pro_athlete/teams./american_football/football_historical_roster_position/team	/medicine/icd_9_cm_classification/parent_classification	1295
['/education/educational_institution_campus/educational_institution', '/president']	/education/educational_institution_campus/educational_institution	/people/marriage_union_type/unions_of_this_type./people/marriage/spouse	152
['/music/genre/parent_genre', '/stylisticOrigin']	/music/genre/parent_genre	/baseball/baseball_team/current_roster./sports/sports_team_roster/player	591
['/basketball/basketball_player/team./sports/sports_team_roster/team', '/team']	/basketball/basketball_player/team./sports/sports_team_roster/team	/book/periodical_subject/periodicals	1007
['/computer/programming_language/language_designers', '/designer']	/computer/programming_language/language_designers	/sports/pro_athlete/teams./basketball/basketball_roster_position/position	572
['/location/us_county/county_seat', '/countySeat']	/location/us_county/county_seat	/business/asset_owner/assets_owned./business/asset_ownership/owned_asset	731
['/book/periodical/publisher./book/periodical_publisher_period/publisher', '/owner']	/book/periodical/publisher./book/periodical_publisher_period/publisher	/colors	1092
['/location/hud_county_place/place', 'df-schema#seeAlso']	/location/hud_county_place/place	/government/government_office_or_title/category	1158
['/organization/organization/place_founded', '/locationCity']	/organization/organization/place_founded	/comic_books/comic_book_creator/characters_created	975
['/film/film_crewmember/films_crewed./film/film_crew_gig/film_crew_role', '/occupation']	/film/film_crewmember/films_crewed./film/film_crew_gig/film_crew_role	/base/popstra/celebrity/breakup./base/popstra/breakup/participant	498
['/tv/tv_personality/tv_regular_appearances./tv/tv_regular_personal_appearance/appearance_type', '/occupation']	/tv/tv_personality/tv_regular_appearances./tv/tv_regular_personal_appearance/appearance_type	/base/popstra/celebrity/breakup./base/popstra/breakup/participant	656
['/transportation/road/end2./transportation/road_starting_point/location', '/routeJunction']	/transportation/road/end2./transportation/road_starting_point/location	/baseball/baseball_player/batting_stats./baseball/batting_statistics/team	450
['/business/business_operation/revenue./measurement_unit/dated_money_value/currency', '/revenue']	/business/business_operation/revenue./measurement_unit/dated_money_value/currency	/food/dish/ingredients	602
['/tv/tv_character/appeared_in_tv_program./tv/regular_tv_appearance/series', '/series']	/tv/tv_character/appeared_in_tv_program./tv/regular_tv_appearance/series	/computer/operating_system/parent_os	800
['/military/military_commander/military_commands./military/military_command/military_conflict', '/battle']	/military/military_commander/military_commands./military/military_command/military_conflict	/book/periodical/publisher./book/periodical_publisher_period/publisher	1147
['/music/genre/artists', '/musicSubgenre']	/music/genre/artists	/tv/tv_program/subjects	935
['/sports/sports_team_owner/teams_owned', '/occupation']	/sports/sports_team_owner/teams_owned	/base/popstra/celebrity/breakup./base/popstra/breakup/participant	911
['/people/person/education./education/education/institution', '/almaMater']	/people/person/education./education/education/institution	/education	265
['/government/politician/government_positions_held./government/government_position_held/basic_title', '/office']	/government/politician/government_positions_held./government/government_position_held/basic_title	/food/ingredient/compatible_with_dietary_restrictions	510
['/film/film/subjects', '/basedOn']	/film/film/subjects	/government/politician/government_positions_held./government/government_position_held/legislative_sessions	1131
['/user/alexander/philosophy/philosopher/era', '/era']	/user/alexander/philosophy/philosopher/era	/law/inventor/inventions	813
['/soccer/football_team/manager./soccer/football_team_management_tenure/manager', '/coach']	/soccer/football_team/manager./soccer/football_team_management_tenure/manager	/film/film/release_date_s./film/film_regional_release_date/film_release_distribution_medium	1272
['/people/person/profession', '/occupation']	/people/person/profession	/base/popstra/celebrity/breakup./base/popstra/breakup/participant	1446
['/music/musical_group/member./music/group_membership/member', '/bandMember']	/music/musical_group/member./music/group_membership/member	/cvg/computer_videogame/characters./cvg/game_performance/character	1436
['/influence/influence_node/peers./influence/peer_relationship/peers', '/influencedBy']	/influence/influence_node/peers./influence/peer_relationship/peers	/architecture/structure/architect	339
['/film/film/directed_by', '/director']	/film/film/directed_by	/military/military_person/participated_in_conflicts	300
['/olympics/olympic_athlete/medals_won./olympics/olympic_medal_honor/country', '/country']	/olympics/olympic_athlete/medals_won./olympics/olympic_medal_honor/country	/locationCountry	780
['/finance/currency/countries_used', '/usingCountry']	/finance/currency/countries_used	/common/webpage/category	1468
